0 31 0 25 0 0 15 12 0 24 38 7 8
2 32 29 1 34 1 0 31 3 13 21 27 6
19 30 18 0 4 5 16 20 4 4 15 13 4
5 33 32 24 35 37 19 30 11 28 35 8 27
18 16 17 6 3 23 2 28 0 33 23 26 6
11 7 22 12 0 2 0 34 10 3 20 21 7
5 26 36 1 9 10 7 3 25 22 6 14 8
5 9 38 2 29 8 0 36 1 17 0 37 14

0 0 0 0 0 0 0 15 0 36 26 35 27
16 12 13 0 10 21 0 33 8 31 31 19 9
11 0 34 0 32 9 16 3 7 34 7 4 12
10 4 0 25 22 6 8 3 0 17 11 24 0
0 2 5 23 18 18 5 29 0 0 6 19 28
20 22 24 26 0 13 0 29 38 0 0 17 37
30 37 1 0 36 38 0 21 14 35 30 15 0
14 23 1 33 0 2 0 25 32 27 0 20 28

0 0 0 0 0 0 0 21 0 37 32 12 0
0 0 14 0 33 9 0 0 13 20 0 0 31
25 0 9 0 29 0 32 33 25 16 17 36 26
35 0 0 23 19 0 0 22 0 17 37 0 0
0 18 22 16 0 14 26 0 0 0 23 10 30
27 28 11 10 0 34 0 13 11 0 0 36 35
18 15 0 0 0 30 0 34 19 28 0 27 0
15 0 0 29 0 20 0 24 21 24 0 31 12

0 0 0 0 0 0 0 13 0 4 38 12
0 0 15 0 38 0 0 0 5 7 0 0
9 0 6 0 0 0 9 0 1 5 2 0
3 0 0 0 3 0 0 0 0 10 0 0
0 15 13 0 0 12 14 0 0 0 14 7
10 4 11 8 0 0 0 6 0 0 0 1
0 11 0 0 0 0 0 0 8 2 0 0