0 26 0 7 0 7 24 23 10 21 36 35 27
32 24 28 7 1 30 0 38 32 4 16 2 21
17 0 10 11 34 19 4 0 22 17 8 3 30
0 1 28 12 29 20 2 0 22 29 0 2 36
37 23 5 8 14 6 8 0 25 5 4 15 9
6 31 2 34 5 1 3 13 26 0 6 25 0
18 20 38 1 35 37 9 3 12 19 11 7 15
33 14 4 8 18 31 5 13 3 33 16 6 27

0 0 0 24 0 0 1 0 10 0 30 24 0
32 3 29 17 36 23 0 38 13 0 2 20 22
28 0 0 18 0 11 5 0 16 17 15 12 30
0 27 31 0 11 20 15 0 32 21 0 5 25
6 27 8 4 10 36 14 0 8 2 0 6 0
34 38 37 35 22 13 7 0 28 0 7 16 0
0 25 1 19 14 34 9 12 18 26 0 37 35
19 21 33 0 26 9 29 0 31 3 23 33 4

0 0 0 36 0 0 15 0 26 0 31 17 0
12 20 32 29 25 18 0 17 21 0 0 10 0
12 0 0 28 0 30 15 0 35 0 24 37 0
0 30 13 0 0 9 37 0 21 0 0 25 11
0 0 22 0 23 27 0 0 20 0 0 26 0
22 0 29 24 19 0 23 0 11 0 33 0 0
0 19 33 10 16 18 27 31 34 16 0 0 0
13 34 32 0 14 0 35 0 28 14 36 0 9

0 0 0 10 0 0 5 0 7 0 0 0
0 7 12 12 2 9 0 0 0 0 0 11
15 0 0 8 0 15 0 0 4 0 0 4
0 11 2 0 0 5 0 0 13 0 0 0
0 0 13 0 38 0 0 0 6 0 0 9
8 0 0 0 6 0 0 0 3 0 0 0
0 0 14 3 1 14 0 1 10 38 0 0