0 1 2 1 1 1 1 1 0
1 1 1 1 1 1 1 1 1
1 1 2 1 1 1 1 1 1

0 1 1 1 1 1 1 1 0
1 1 1 1 1 1 1 1 0
1 1 1 1 1 1 1 1 1

0 0 6 7 8 1 2 2 0
0 1 1 1 1 1 4 19 0
0 12 16 1 8 1 30 0 0

0 0 8 17 0 23 0 0
0 0 10 0 4 0 0 0