1 1 2 3 4 5 6 7 8 9 10 11 12
2 0 6 1 2 3 6 5 7 8 0 0 0
1 1 2 3 20 30 25 15 10 5 10 0 0
3 1 2 3 4 5 6 7 8 9 10 11 12
15 1 2 3 4 5 6 7 8 9 10 11 12
17 1 2 3 4 5 6 7 8 9 10 11 12
0 0 6 1 2 3 6 5 7 8 0 0 0
0 0 0 0 0 3 6 5 7 8 0 0 1

0 0 0 0 0 0 0 0 0 0 0 0 0
0 0 0 2 15 20 26 14 8 0 0 0 0
0 0 0 9 5 17 18 20 26 0 0 0 0
0 0 0 9 5 17 18 20 26 0 0 0 0
0 0 0 9 5 17 18 20 26 0 0 0 0
0 0 0 9 5 17 18 20 26 0 0 0 0
0 0 0 9 5 17 18 20 26 0 0 0 0
0 0 0 9 5 17 18 20 26 0 0 0 0

0 0 0 0 0 0 0 0 0 0 0 0 0
0 0 0 0 0 0 0 0 0 0 0 0 0
0 0 0 0 0 5 18 10 15 0 0 0 0
0 0 0 0 8 12 18 5 20 0 0 0 0
0 0 0 0 6 17 29 19 30 0 0 0 0
0 0 0 0 0 17 18 28 7 0 0 0 0
0 0 0 0 0 0 0 0 0 0 0 0 0
0 0 0 0 0 0 0 0 0 0 0 0 0

0 0 0 0 0 0 0 0 0 0 0 0
0 0 0 0 0 0 0 0 0 0 0 0
0 0 0 0 0 2 0 0 0 0 0 0
0 0 0 0 3 1 4 0 0 0 0 0
0 0 0 0 0 5 0 0 0 0 0 0
0 0 0 0 0 0 0 0 0 0 0 0
0 0 0 0 0 0 0 0 0 0 0 0