8 31 7 37 0 32 26 36 13 5 36 14 2
23 20 6 1 4 38 0 27 22 1 0 0 2
4 10 21 0 29 6 0 15 7 34 23 1 3
2 0 9 19 7 11 0 3 30 5 12 11 32
0 5 3 26 24 38 21 18 5 12 25 29 3
28 6 9 0 37 27 8 10 17 25 1 6 15
13 33 20 4 14 35 16 0 19 2 18 16 8
17 24 7 31 0 28 35 4 34 30 22 33 8

2 34 15 30 0 28 38 0 23 16 0 2 29
10 0 20 21 14 32 0 0 11 0 0 0 9
4 23 25 0 9 3 0 13 21 18 5 17 29
30 0 12 13 16 35 0 31 14 36 17 18 10
0 6 0 27 33 19 31 24 26 37 0 15 6
37 0 5 0 1 36 25 28 35 7 3 20 0
27 24 32 19 0 12 34 0 22 11 26 0 0
0 1 0 8 0 22 38 0 33 8 0 4 7

37 23 24 22 0 37 0 0 28 35 0 30 33
11 0 28 0 19 0 0 0 0 0 0 0 25
24 15 35 0 0 21 0 18 36 12 0 22 0
0 0 29 32 34 0 0 10 31 23 31 15 11
0 10 0 30 25 27 29 18 36 9 0 16 14
20 0 33 0 32 0 0 26 9 20 21 0 0
0 26 0 0 0 14 0 0 27 13 12 0 0
0 16 0 19 0 0 0 0 17 17 0 34 13

0 1 11 8 0 12 0 0 15 7 0 12
0 0 38 0 9 0 0 0 0 0 0 0
1 38 2 0 0 0 0 5 0 8 0 0
0 0 0 7 6 0 0 2 0 10 10 11
0 0 0 0 13 4 9 4 0 0 0 0
5 0 14 0 0 0 0 14 3 6 0 0
0 13 0 0 0 15 0 0 3 0 0 0